Русское имя: Шоё Хината	 Японское имя: 日向 翔陽	 Другое: Shou-chan, Shorty, Strongest Decoy, Shrimp
Русское имя: Осаму Дазай	 Японское имя: 太宰 治	 Другое: Osamu Dazai
Русское имя: Тобио Кагэяма	 Японское имя: 影山 飛雄	 Другое: King of the Court
Русское имя: Зеро Ту	 Японское имя: ゼロツー	 Другое: 002, Iota
Русское имя: Кэнма Козумэ	 Японское имя: 孤爪 研磨	 Другое: Kenma Kozume
Русское имя: Чуя Накахара	 Японское имя: 中原 中也	 Другое: Chuuya Nakahara
Русское имя: Джузо Сузуя	 Японское имя: 鈴屋 什造	 Другое: Rei, CCG's Jason
Русское имя: Ю Нишиноя	 Японское имя: 西谷 夕	 Другое: Noya, Nishiya, Guardian Deity
Русское имя: Кэй Цукишима	 Японское имя: 月島 蛍	 Другое: Tsukki
Русское имя: Шото Тодороки	 Японское имя: 轟 焦凍	 Другое: Shouto Todoroki
Русское имя: Тэцуро Куроо	 Японское имя: 黒尾 鉄朗	 Другое: Tetsurou Kuroo
Русское имя: Нагиса Шиота	 Японское имя: 潮田 渚	 Другое: Nagisa Shiota
Русское имя: Кэн Канэки	 Японское имя: 金木 研	 Другое: Centipede, Dragon, Eyepatch, One-Eyed King, The Black Reaper
Русское имя: Наруто Узумаки	 Японское имя: うずまき ナルト	 Другое: Nine-Tails Jinchuuriki
Русское имя: Итачи Учиха	 Японское имя: うちは イタチ	 Другое: Itachi Uchiha
Русское имя: Рэйчел Гарднер	 Японское имя: レイチェル・ガードナー	 Другое: Ray
Русское имя: Коши Сугавара	 Японское имя: 菅原 孝支	 Другое: Suga
Русское имя: Маи Сакурадзима	 Японское имя: 桜島 麻衣	 Другое: Mai Sakurajima
Русское имя: Какаши Хатакэ	 Японское имя: はたけ カカシ	 Другое: The Copy Ninja
Русское имя: Юмэко Джабами	 Японское имя: 蛇喰 夢子	 Другое: Yumeko Jabami
Русское имя: Тору Оикава	 Японское имя: 及川 徹	 Другое: Grand King
Русское имя: Изуку Мидория	 Японское имя: 緑谷 出久	 Другое: Deku
Русское имя: Карма Акабанэ	 Японское имя: 赤羽 業	 Другое: Red Demon
Русское имя: Маширо Шина	 Японское имя: 椎名 ましろ	 Другое: Mashiron
Русское имя: Тока Киришима	 Японское имя: 霧嶋 董香	 Другое: Rabbit
Русское имя: Дайсукэ Камбэ	 Японское имя: 神戸 大助	 Другое: Daisuke Kanbe
Русское имя: Цутигомори	 Японское имя: 土籠	 Другое: Number 5, Spider-face
Русское имя: Ацуши Накаджима	 Японское имя: 中島 敦	 Другое: Atsushi Nakajima
Русское имя: Кацуки Бакуго	 Японское имя: 爆豪 勝己	 Другое: Kacchan
Русское имя: Мику Накано	 Японское имя: 中野 三玖	 Другое: Miku Nakano
Русское имя: Нами	 Японское имя: ナミ	 Другое: Cat Burglar, Namizo
Русское имя: Саскэ Учиха	 Японское имя: うちは サスケ	 Другое: Sasuke Uchiha
Русское имя: Айзек Фостер	 Японское имя: アイザック・フォスター	 Другое: Zack
Русское имя: Икуя Киришима	 Японское имя: 桐嶋 郁弥	 Другое: Ikuya Kirishima
Русское имя: Химико Тога	 Японское имя: 渡我 被身子	 Другое: Himiko Toga
Русское имя: Л Лоулайт	 Японское имя: エル ローライト	 Другое: Ryuga Hideki, Ryuzaki, Eraldo Coil, Deneuve
Русское имя: Хисока Мороу	 Японское имя: ヒソカ・モロウ	 Другое: Hisoka Morow
Русское имя: Ута	 Японское имя: ウタ	 Другое: No face
Русское имя: Асахи Азуманэ	 Японское имя: 東峰 旭	 Другое: Ace
Русское имя: Леви	 Японское имя: リヴァイ	 Другое: Levi 
Русское имя: Сакута Адзусагава	 Японское имя: 梓川 咲太	 Другое: Sakuta Azusagawa
Русское имя: Ято	 Японское имя: 夜ト	 Другое: God of Calamity, Delivery God, Yatogami, Yatty
Русское имя: Субару Сакамаки	 Японское имя: 逆巻 スバル	 Другое: Subaru Sakamaki
Русское имя: Киллуа Золдик	 Японское имя: キルア=ゾルディック	 Другое: Kil
Русское имя: Рюноскэ Акутагава	 Японское имя: 芥川 龍之介	 Другое: Ryuunosuke Akutagawa
Русское имя: Сакура Харуно	 Японское имя: 春野 サクラ	 Другое: Forehead Girl
Русское имя: Джуго	 Японское имя: ジューゴ	 Другое: Juugo 
Русское имя: Селти Стурлусон	 Японское имя: セルティ・ストゥルルソン	 Другое: The Headless Rider, The Black Rider
Русское имя: Фёдор Достоевский	 Японское имя: フョードル・ドストエフスキー	 Другое: Fyodor Dostoyevsky
Русское имя: Ризэ Камиширо	 Японское имя: 神代 利世	 Другое: Glutton, Binge Eater
Русское имя: Unmei	 Японское имя: 運命	 Другое: Unmei
Русское имя: Такт Асахина	 Японское имя: 朝雛 タクト	 Другое: Takt Asahina
Русское имя: Mai Kirishima	 Японское имя: 霧島 舞	 Другое: Shirley
Русское имя: Andrei Ivanov	 Японское имя: 安德烈·伊万诺夫	 Другое: Andrei Ivanov
Русское имя: Сигурэ Даниэль Кай	 Японское имя: 時雨・ダニエル・魁	 Другое: Shigure Daniel Kai
Русское имя: Принцесса Судзухико	 Японское имя: 鈴彦姫	 Другое: Suzuhiko-hime
Русское имя: Сасукэ	 Японское имя: 佐助	 Другое: Sasuke
Русское имя: Никити	 Японское имя: 仁吉	 Другое: Nikichi
Русское имя: Бёбунодзоки	 Японское имя: 屏風のぞき	 Другое: Byoubunozoki
Русское имя: Вакаданна	 Японское имя: 若だんな	 Другое: Wakadanna
